{
  "name": "First Dungeon",
  "config": {
    "width": 16,
    "height": 16,
    "cellSize": 1.0,
    "wallHeight": 1.0,
    "playerSpawn": {
      "x": 3.5,
      "z": 3.5,
      "facing": 3.14159
    }
  },
  "tileTypes": {
    "0": "empty",
    "1": "stone_wall",
    "2": "brick_wall",
    "3": "wood_wall",
    "4": "door_dungeon2"
  },
  "map": [
    [1, 1, 1, 1, 1, 1, 1, 4, 1, 1, 1, 1, 1, 1, 1, 1],
    [1, 0, 0, 0, 0, 0, 1, 0, 0, 0, 0, 0, 0, 0, 0, 1],
    [1, 0, 0, 0, 0, 0, 1, 0, 0, 0, 0, 0, 0, 0, 0, 1],
    [1, 0, 0, 0, 0, 0, 2, 0, 2, 0, 0, 0, 0, 0, 0, 1],
    [1, 0, 0, 0, 0, 0, 0, 0, 0, 0, 0, 0, 2, 0, 0, 1],
    [1, 0, 2, 2, 0, 0, 0, 3, 0, 0, 0, 0, 2, 0, 0, 1],
    [1, 0, 2, 0, 0, 0, 0, 3, 0, 0, 0, 0, 0, 0, 0, 1],
    [1, 0, 2, 0, 0, 0, 0, 0, 0, 0, 0, 0, 0, 0, 0, 1],
    [1, 0, 0, 0, 0, 0, 0, 0, 0, 0, 0, 0, 0, 0, 0, 1],
    [1, 0, 0, 0, 0, 0, 0, 0, 0, 0, 0, 0, 1, 1, 0, 1],
    [1, 0, 0, 0, 3, 0, 0, 0, 0, 0, 0, 0, 1, 1, 0, 1],
    [1, 0, 0, 0, 3, 0, 0, 0, 0, 0, 0, 0, 0, 0, 0, 1],
    [1, 0, 0, 0, 3, 3, 3, 3, 0, 0, 0, 0, 0, 0, 0, 1],
    [1, 0, 0, 0, 0, 0, 0, 0, 0, 0, 0, 0, 0, 0, 0, 1],
    [1, 0, 0, 0, 0, 0, 0, 0, 0, 0, 0, 0, 0, 0, 0, 1],
    [1, 1, 1, 1, 1, 1, 1, 1, 1, 1, 1, 1, 1, 1, 1, 1]
  ],
  "enemies": [
    {
      "type": "draugr",
      "gridX": 5,
      "gridZ": 5
    },
    {
      "type": "bandit",
      "gridX": 10,
      "gridZ": 10
    }
  ]
}
